111111111111111111111111111111111111111111111
10000000000100000000000010C11100000000C111111
1110000111000111C1111111000000000000001110001
11P01111100000000000111C000111000000000011111
1111111111111111000000001111111100000011110E1
111000000000000001111000011111000111111000001
100000011111111000000000000000000000000011111
111111111111111111111111111111111111111111111
