1111111111111111
1001000000000C01
1000011111000101
1P00011EC0000001
1111111111111111
