1111111111111111111111111111111111111111111111111
10000000000010000000000001000000000000111E0000001
1000000000011100000000001000000000000010111100001
10000000P001000001100001000111000000C000001110011
1110001111010000000000011110000001111000011100001
1C00001111000000000000000000011100000000000000111
1000000000000000000000000000000000000000000011111
1000000001111111C00000000000011111111000000000001
1110001111010000000000011110000001111000011100001
1C00001111000000000000000000011100000000000000111
1000000000000000000000000000000000000000000011111
1000000001111111C00000000000011111111000000000001
1110001111010000000000011110000001111000011100001
1C00001111000000000000000000011100000000000000111
1000000000000000000000000000000000000000000011111
1000000001111111C00000000000011111111000000000001
1111111111111111111111111111111111111111111111111
