1111111111111111111111111111111111111111111111111
1C000000000010000000000001000000000000111E0000001
1000000000011100000000001000000000000010111100001
100000000001000001100001000111000000C000001110011
1110001111010000000000011110000001111000011100001
1C00001111000000000C00000000011100000000000000111
1000000000000000000000000000000000000000000011111
1000000001111111C00000000000011111111000000000001
1110001111010000000000011110000001111000011100001
1C00001111000000000000000000011100000000000000111
100000000000000000000000C000000000000000000011111
1000000001111111C00000000000011111111000000000001
1110001111010000000000011110000001111000011100001
1C00001111000000000000000000011100000000000000111
1000000000000000000000000000000000000000000011111
1111111111111111111111P11111111111111111111111111
1111111111111111111111111111111111111111111111111
